 ################### , #        #        # , # ## ### # ### ## # , #                 # , # ## # ##### # ## # , #    #   #   #    # , #### ### # ### #### ,    # #   0   # #    ,##### # ##=## # #####,        #213#        ,##### # ##### # #####,    # #       # #    , #### # ##### # #### , #        #        # , # ## ### # ### ## # , #  #  ...P     #  # , ## # # ##### # # ## , #    #   #   #    # , # ###### # ###### # , #                 # , ################### ,
 ################### , #........#........# , #o##.###.#.###.##o# , #.................# , #.##.#.#####.#.##.# , #....#...#...#....# , ####.### # ###.#### ,    #.#   0   #.#    ,#####.# ##=## #.#####,     .  #213#  .     ,#####.# ##### #.#####,    #.#       #.#    , ####.# ##### #.#### , #........#........# , #.##.###.#.###.##.# , #o.#.....P.....#.o# , ##.#.#.#####.#.#.## , #....#...#...#....# , #.######.#.######.# , #.................# , ################### ,
# ########.######## #,#.......o# #o.......#,##.##.#### ####.##.##, #.................# ,##.##.#.#####.#.##.##, .....#...#...#..... ,#####.### # ###.#####,#  #..    0    ..#  #,####### ##=## #######,    ..# #213# #..    ,#####.# ##### #.#####,#o....#       #....o#,#####.# ## ## #.#####, #.......# #.......# ,##.##.#### ####.##.##,  ..#.....P.....#..  ,###.#.#.#####.#.#.###,#.....#.......#.....#,#.##.##.##.##.##.##.#,# #.....o#.#o.....# #,# ########.######## #,
#####################,......#.......#......,#####.#.#####.#.#####,#.........#.........#,#.#####.#.#.#.#####.#,#o#.....#...#.....#o#,#.#.###.#####.###.#.#,#.....#...0...#.....#,#####.#.##=##.#.#####,#.....#.#213#.#.....#,#.###...#####...###.#,#...#.#.......#.#...#,###.#.##.###.##.#.###,  #.#.##.###.##.#.#  ,  #......###......#  ,###.####.###.####.###,.......#..P..#.......,###.##.#.###.#.##.###,#o#.##.#.###.#.##.#o#,#...................#,#####################,
#####################,#.......#.o.#.......#,#.#####.#.#.#.#####.#,#.#.......#.......#.#,#...#.###.#.###.#...#,###.#...........#.###,....###.#####.###....,#.#.......0.......#.#,#.###.#.##=##.#.###.#,#.....#.#213#.#.....#,#o##.##.#####.##.##o#,#.#...............#.#,#...#.###.#.###.#...#,##.##.#...#...#.##.##,#.....#.#####.#.....#,#.#.#.....P.....#.#.#,#.###.###.#.###.###.#,#.....#...#...#.....#,#.###.#.#####.#.###.#,#.....#...o...#.....#,#####################,
#####################,#.....#.......#.....#,#.###.#.#####.#.###.#,#o.................o#,##.#.####.#.####.#.##,##.#.####.#.####.#.##,...#......#......#...,##.####.#####.####.##, #........0........# , #.####.##=##.####.# , #.##...#213#...##.# ,##.##.#.#####.#.##.##,......#.......#......,##.######.#.######.##, #........#........# ,##.####.#####.####.##,#.........P.........#,#.###.###.#.###.###.#,#o###.#...#...#.###o#,#.......#...#.......#,#####################,
